10 10
1111111111
1000101001
1000131001
1000101001
1000101001
1000101001
1000000001
1002000001
1000000001
1111111111
