10 10
1111111111
1001000031
1001010001
1111011111
1200300001
1111001111
1001010001
1001010001
1001010001
1111111111
